16 16
0 0 0 0 0 0 0 0 0 0 0 0 0 0 0 0 
0 0 0 0 0 0 0 0 0 0 0 0 0 0 0 0 
0 0 0 0 0 0 0 0 0 0 0 0 0 0 0 0 
0 0 0 0 0 0 0 0 0 0 0 0 0 0 0 0 
0 0 0 0 0 0 0 0 0 0 0 0 0 0 0 0 
0 0 0 0 0 0 0 0 0 0 0 0 0 0 0 0 
10 10 10 10 10 0 0 4 4 0 0 0 0 0 0 0 
0 0 0 0 0 0 0 0 0 0 0 4 4 0 0 0 
0 0 0 0 0 0 0 0 0 0 0 0 0 0 0 0 
0 0 0 0 0 0 0 0 0 0 0 0 0 0 4 4 
0 0 0 0 0 0 0 0 0 0 0 4 4 0 0 0 
1 0 0 0 0 0 0 0 4 4 0 0 0 0 0 0 
0 0 0 0 0 4 4 0 0 0 0 0 0 0 0 0 
0 0 0 0 4 3 3 4 0 0 0 4 0 0 0 0 
4 4 4 4 3 3 3 3 4 4 4 3 4 4 4 4 
3 3 3 3 3 3 3 3 3 3 3 3 3 3 3 3 
