16 16
1 0 0 0 0 0 0 0 0 0 0 0 0 0 0 0 
4 4 4 4 4 4 4 4 4 4 4 0 0 0 0 0 
3 3 3 3 3 3 3 3 3 3 3 4 0 0 0 0 
3 3 3 3 3 3 3 3 3 3 3 3 4 0 0 0 
0 0 0 0 0 0 0 0 0 0 0 0 0 0 0 0 
0 0 0 0 0 0 0 0 0 0 0 0 0 0 0 4 
0 0 0 0 0 0 0 0 0 0 0 0 0 0 4 3 
0 0 0 0 0 0 0 0 0 9 0 8 0 4 3 3 
0 0 0 0 0 0 4 4 4 4 4 4 4 3 3 3 
0 0 0 0 0 0 0 0 3 3 3 3 3 3 3 3 
4 4 4 0 0 0 0 0 0 0 0 0 0 0 0 0 
3 3 3 4 0 0 0 0 0 0 0 0 0 0 0 0 
3 3 3 3 0 0 0 0 0 0 0 0 0 0 0 0 
3 3 3 3 4 0 0 0 0 0 0 0 0 0 0 0 
4 4 4 4 4 4 4 4 4 4 4 4 4 4 4 4 
0 0 0 0 0 0 0 0 0 0 0 0 0 0 0 0 
