16 12
0 0 0 0 0 0 0 0 0 0 0 0 0 0 0 0 
0 0 1 0 0 0 0 0 0 0 0 0 0 0 0 0 
2 2 2 2 2 2 2 0 0 0 4 4 0 0 0 0 
0 0 0 0 0 0 0 10 4 0 0 0 4 4 0 0 
0 0 0 0 0 0 0 10 0 0 0 0 0 0 0 0 
0 0 0 0 0 0 0 10 0 0 0 0 0 0 0 0 
0 0 0 0 0 0 4 10 0 0 0 0 0 4 0 0 
0 0 0 0 0 0 0 10 0 0 0 0 0 0 0 0 
0 0 0 0 0 0 0 10 0 8 0 0 0 0 0 0 
0 0 10 10 10 10 0 9 0 4 4 4 4 4 11 0 
4 4 7 7 7 7 4 4 4 3 3 3 3 3 4 4 
3 3 6 6 6 6 3 3 3 3 3 3 3 3 3 3 
