16 12
0 0 0 0 0 0 0 0 0 0 0 0 0 0 0 0 
0 0 0 0 0 0 0 0 0 0 0 0 0 0 0 0 
0 0 0 0 0 0 0 0 0 0 0 0 0 0 0 0 
0 0 0 0 0 0 0 0 0 0 0 0 0 0 0 0 
0 0 0 0 0 0 0 0 0 0 0 0 0 0 0 0 
1 0 0 0 0 0 0 0 0 0 0 0 0 0 0 0 
4 4 0 0 0 0 0 0 0 0 0 0 0 5 5 5 
11 13 0 0 10 10 4 10 10 10 0 0 0 5 9 5 
4 4 4 0 0 0 3 0 0 0 4 4 4 4 4 4 
3 3 3 4 0 0 3 0 0 4 3 3 3 3 2 2 
2 3 3 3 4 4 3 4 4 3 3 3 3 2 2 2 
2 2 3 3 3 3 3 3 3 3 3 3 2 2 2 2 
