16 12
0 0 0 0 0 0 4 4 4 4 4 4 4 4 4 4 
1 0 0 0 0 0 3 3 3 3 3 3 3 3 3 3 
4 4 4 4 4 4 3 3 3 3 3 3 3 3 3 3 
3 3 3 3 3 3 3 3 3 3 3 3 3 3 3 3 
2 3 2 3 2 3 2 3 2 3 2 3 3 3 3 3 
7 7 3 3 3 3 0 3 3 3 3 3 3 3 3 3 
6 6 3 3 3 3 0 3 3 3 3 3 3 3 3 3 
6 2 3 2 3 2 3 2 3 2 3 3 3 3 3 3 
2 2 2 2 2 2 0 0 0 0 0 0 0 0 0 0 
2 2 2 2 2 2 0 5 0 0 0 0 0 0 0 0 
2 2 2 2 2 2 5 5 0 0 0 0 0 0 0 11 
2 2 2 2 2 2 2 2 2 2 2 2 2 2 2 2 
