16 12
2 0 0 0 0 2 2 2 2 2 2 2 2 2 2 2 
2 0 0 0 0 2 2 2 2 2 2 2 2 2 2 2 
2 0 1 0 0 2 2 2 2 2 2 2 2 2 2 2 
2 2 2 2 4 2 2 0 0 2 2 2 2 2 2 2 
2 2 2 2 3 0 0 0 0 2 2 2 2 2 2 2 
2 2 2 2 3 0 0 0 0 5 2 0 0 0 0 0 
2 2 2 2 2 4 4 4 4 0 2 0 0 0 11 0 
2 2 2 2 2 2 2 2 5 2 2 0 0 2 2 2 
2 2 2 2 2 2 2 2 5 2 0 0 2 2 2 2 
2 2 2 2 2 2 2 2 5 0 0 2 2 2 2 2 
2 2 2 2 2 2 2 2 2 2 2 2 2 2 2 2 
2 2 2 2 2 2 2 2 2 2 2 2 2 2 2 2 
