16 12
0 0 0 0 0 0 0 0 0 0 0 0 0 0 0 0 
0 0 0 0 0 0 0 0 0 0 0 0 0 0 0 0 
0 0 0 0 0 0 0 0 0 0 0 0 0 0 0 0 
0 0 0 0 0 0 0 0 0 0 0 0 0 0 0 0 
4 4 4 4 4 4 4 4 4 4 4 4 4 4 4 4 
3 3 3 3 3 3 3 3 3 3 3 3 3 3 3 3 
0 0 0 0 0 0 0 0 0 0 0 0 3 0 0 0 
0 0 0 0 0 0 0 0 0 0 0 0 3 0 0 0 
0 0 0 0 0 4 4 7 7 7 7 7 3 0 0 11 
1 0 0 4 4 2 2 6 6 6 6 6 6 7 4 4 
4 4 0 0 0 0 0 6 6 6 6 6 6 2 3 3 
3 3 4 4 4 2 2 2 2 2 2 2 2 2 3 3 
