16 24
0 0 0 0 0 0 0 0 0 0 0 0 0 0 0 0 
1 0 0 0 0 0 0 0 0 0 0 0 0 0 0 0 
4 4 4 4 4 0 0 0 4 4 0 0 0 0 0 0 
3 2 2 3 0 10 10 10 2 3 4 4 4 4 10 10 
2 2 0 0 0 0 0 0 2 2 2 2 2 7 7 7 
2 0 0 0 0 0 0 0 2 2 2 2 6 6 6 6 
0 0 0 0 0 0 0 0 0 2 2 6 6 6 6 6 
0 0 10 0 0 4 2 2 2 2 2 6 6 6 6 6 
0 0 0 0 0 0 0 0 0 2 2 2 2 6 6 6 
0 0 0 0 0 0 0 0 0 0 0 0 2 2 6 6 
9 0 0 0 0 0 0 0 0 0 0 0 0 2 6 6 
4 0 0 10 10 0 0 10 10 0 0 10 10 2 6 6 
3 7 7 7 7 7 7 7 7 7 7 7 7 2 6 6 
2 2 2 2 2 2 2 2 2 2 2 2 6 2 6 6 
2 2 2 2 2 2 0 0 0 3 9 13 6 2 2 6 
2 0 0 0 0 0 0 0 0 0 3 3 6 0 2 2 
0 0 0 0 0 0 4 0 0 0 0 0 6 0 0 2 
0 0 0 0 0 4 3 7 7 4 7 7 6 7 7 2 
0 0 4 4 4 3 3 3 3 6 6 6 6 2 2 2 
0 4 3 3 3 3 2 2 2 2 2 2 2 2 2 2 
0 0 0 0 0 0 0 0 0 0 0 0 0 0 5 11 
0 0 0 0 0 0 0 0 0 0 0 0 0 5 5 2 
4 4 4 4 4 4 4 4 4 0 0 0 0 13 2 2 
3 3 3 3 3 3 3 3 3 4 4 4 4 2 2 2 
