16 12
0 0 0 0 0 0 0 0 0 0 0 0 0 0 0 0 
0 0 0 0 0 0 0 0 0 0 0 0 0 0 0 0 
0 0 0 0 0 0 0 0 0 0 0 0 0 0 0 0 
0 0 0 0 0 0 0 0 0 0 0 0 0 0 0 0 
0 1 0 0 0 0 0 0 0 0 0 0 0 0 0 0 
5 5 5 5 5 5 5 0 0 0 0 5 5 5 5 5 
0 0 0 0 0 0 0 4 4 4 4 0 0 0 0 0 
4 4 2 2 2 4 4 3 3 3 3 0 4 4 4 4 
0 0 0 11 0 3 0 0 0 0 0 0 3 3 3 3 
2 2 2 2 2 2 2 2 2 2 2 2 3 3 3 3 
2 2 2 2 2 2 2 2 2 2 2 2 3 3 3 3 
2 2 2 2 2 2 2 2 2 2 2 2 3 3 3 3 
