18 12
0 0 0 0 0 0 0 0 0 0 0 0 0 0 0 0 0 0 
0 4 4 4 4 4 4 4 4 10 4 4 0 0 0 0 1 0 
0 3 0 0 0 0 0 0 3 10 3 3 4 4 0 0 0 0 
0 3 11 10 10 0 0 0 3 10 3 3 3 3 4 4 4 4 
0 3 10 0 0 10 0 0 3 10 3 0 0 0 0 0 0 0 
0 3 0 0 0 0 0 10 3 10 3 0 0 0 0 0 0 0 
0 3 0 0 10 10 10 10 3 3 3 0 10 10 0 0 0 0 
0 3 10 0 0 0 0 0 0 0 0 0 10 10 10 0 0 0 
0 3 10 10 0 0 0 0 0 0 0 0 10 10 10 10 0 0 
0 3 0 0 10 10 10 10 10 10 10 10 0 0 0 0 0 10 
0 0 0 0 0 0 0 0 0 0 0 0 0 0 0 0 10 10 
4 4 4 4 4 4 4 4 4 4 4 4 4 4 4 4 4 4 
