20 15
2 2 2 2 2 2 2 2 2 2 2 2 2 2 2 2 2 2 2 2 
2 2 0 0 0 5 5 0 0 0 0 0 0 0 0 0 0 0 0 0 
2 0 0 0 0 5 5 0 0 9 0 0 0 0 0 0 0 0 0 0 
0 11 0 0 0 5 5 0 4 4 4 0 0 0 0 0 0 0 0 0 
4 4 0 0 0 5 5 4 3 3 3 4 4 4 4 4 4 0 0 0 
3 3 0 0 0 5 4 3 3 3 3 3 0 0 0 0 0 0 4 4 
3 3 4 4 4 4 3 3 0 0 0 0 0 0 0 0 0 10 0 0 
2 2 2 2 2 2 2 2 0 0 0 0 0 0 0 0 10 0 0 0 
2 2 2 0 0 0 0 13 0 0 0 0 0 0 4 4 0 0 0 0 
10 0 0 0 0 2 2 2 0 0 0 0 0 10 0 0 0 0 0 0 
10 1 0 0 2 0 0 0 0 2 0 0 10 0 0 0 0 0 0 0 
2 2 2 0 0 0 0 0 2 2 2 2 10 10 10 10 10 10 10 10 
2 2 2 2 2 0 0 0 2 2 2 2 7 7 7 7 7 7 7 7 
2 2 2 2 2 2 2 2 2 2 2 2 6 6 6 6 6 6 6 6 
2 2 2 2 2 2 2 2 2 2 2 2 2 2 2 2 2 2 2 2 
