16 12
0 0 0 0 0 0 0 0 0 0 0 0 0 0 0 0 
0 0 0 0 0 0 0 0 0 0 0 0 0 0 0 0 
0 0 0 0 0 0 0 0 0 0 0 0 0 0 0 0 
0 0 0 0 0 0 0 0 0 0 0 0 0 0 0 0 
0 0 0 0 0 0 0 0 0 0 0 0 0 0 0 0 
0 0 0 0 0 0 0 0 5 5 5 5 5 0 0 0 
0 0 0 0 0 0 0 0 5 4 4 4 5 0 11 0 
0 1 0 0 0 4 4 4 4 3 3 3 4 4 4 4 
2 2 2 2 2 3 3 3 3 3 3 3 3 3 3 3 
2 2 2 2 2 3 3 3 3 3 3 3 3 3 3 3 
2 2 2 2 2 3 3 3 3 3 3 3 3 3 3 3 
2 2 2 2 2 2 2 2 2 2 2 2 2 2 2 2 
