16 12
0 0 0 0 0 0 0 0 0 0 0 0 0 0 0 0 
0 0 0 0 0 0 0 0 0 0 0 0 0 0 0 11 
7 7 7 7 4 4 4 4 0 0 0 0 0 4 4 4 
6 6 3 3 3 3 3 3 0 0 0 0 0 0 0 2 
3 6 3 0 0 0 0 3 0 0 0 0 4 2 0 2 
3 6 3 0 0 0 0 3 10 10 4 4 3 2 0 2 
3 6 3 0 0 13 0 0 0 0 0 0 0 0 0 0 
6 6 7 7 4 4 0 0 0 0 0 0 0 0 0 0 
3 3 3 3 3 0 5 0 0 0 0 0 0 0 0 0 
1 0 0 0 0 0 5 0 0 0 0 0 0 0 0 0 
4 4 4 4 4 0 0 10 4 4 10 10 10 4 4 9 
2 2 2 3 3 4 4 4 3 3 7 7 7 3 3 4 
