16 12
0 0 0 0 0 0 0 0 0 0 0 0 0 0 0 0 
0 0 0 0 0 0 0 0 0 0 0 0 0 0 0 0 
0 0 0 0 0 0 0 0 0 0 0 0 0 0 0 0 
0 0 0 0 0 0 0 0 0 0 0 0 0 0 0 11 
0 0 0 0 0 0 0 0 0 0 0 0 0 0 0 4 
0 0 0 0 0 0 0 0 0 0 0 0 0 0 0 3 
0 0 0 0 0 0 0 0 0 0 0 0 0 0 0 3 
9 0 0 0 0 0 0 0 0 0 0 13 4 4 4 3 
4 4 10 10 10 0 0 1 0 0 0 4 3 2 2 2 
2 2 0 0 0 4 4 4 4 4 0 3 3 3 2 2 
2 7 7 7 7 3 3 3 3 3 7 7 7 7 7 2 
2 6 6 6 6 6 6 6 6 6 6 6 6 6 6 2 
