16 12
0 0 0 0 0 1 0 0 2 0 0 0 0 0 0 0 
2 2 0 2 2 2 2 10 2 0 0 0 0 0 0 0 
7 7 7 7 7 7 2 10 2 0 0 0 0 0 0 0 
6 6 6 6 6 6 2 10 2 0 0 0 0 0 0 11 
6 6 6 2 2 2 2 10 2 0 2 2 2 2 2 2 
6 6 6 6 6 6 2 10 2 7 7 7 7 7 7 7 
2 2 6 6 6 6 2 10 2 2 2 6 6 6 6 6 
6 6 6 6 6 6 2 10 2 6 6 6 6 6 6 6 
6 2 2 2 6 6 2 10 2 6 6 6 6 2 2 2 
6 6 6 6 6 6 2 13 2 6 6 6 6 6 6 6 
6 6 6 6 6 2 2 2 2 2 2 6 6 6 6 6 
6 6 6 6 6 6 6 9 6 6 6 6 6 6 6 6 
