20 12
0 0 0 0 0 0 0 0 0 0 0 0 0 0 0 0 0 9 0 0 
0 0 0 0 0 0 0 0 0 0 0 0 0 0 0 4 4 4 0 4 
4 4 4 4 4 4 4 4 4 4 4 0 0 9 13 3 3 3 0 3 
0 0 0 0 0 0 0 0 0 0 0 0 10 4 4 3 3 3 0 3 
0 0 0 0 0 0 0 0 0 0 0 0 10 3 3 3 3 3 0 3 
0 0 0 0 0 0 0 0 0 4 4 4 4 3 3 3 3 3 0 3 
0 0 0 0 0 0 0 0 0 3 3 3 3 3 3 3 3 3 0 3 
0 0 0 0 0 5 5 5 5 3 0 3 0 3 3 3 3 0 0 3 
0 1 0 0 0 4 4 0 0 3 9 3 0 13 0 0 0 0 13 11 
0 4 4 10 10 3 3 0 0 3 3 3 3 3 3 3 3 3 3 3 
7 3 3 7 7 3 3 7 7 3 3 7 7 7 7 7 7 7 7 7 
6 6 6 6 6 6 6 6 6 6 6 6 6 6 6 6 6 6 6 6 
