16 12
0 0 0 0 0 0 0 0 0 0 0 0 0 0 0 0 
0 0 0 0 0 0 0 0 0 0 0 0 0 0 0 0 
0 0 0 0 0 0 0 0 0 0 0 0 0 0 0 0 
0 0 0 0 0 0 0 0 0 0 0 0 0 0 0 0 
0 0 4 4 4 4 4 4 4 4 4 4 4 4 0 0 
4 0 0 0 0 0 0 0 0 0 0 0 0 0 0 4 
3 4 4 4 0 0 0 0 0 0 0 0 0 4 4 3 
0 0 0 0 0 5 10 10 10 10 10 5 0 0 0 0 
0 0 0 0 5 5 10 10 10 10 10 5 5 0 0 0 
1 0 0 5 5 5 10 10 10 10 10 5 5 5 0 11 
4 4 4 4 4 4 7 7 7 7 7 4 4 4 4 4 
2 2 2 2 2 2 6 6 6 6 6 2 2 2 2 2 
