16 12
0 0 0 0 2 0 2 0 2 0 0 0 0 0 0 0 
0 0 0 0 2 2 2 2 2 0 0 0 0 0 0 0 
0 0 0 0 2 2 2 2 2 0 0 0 0 0 0 0 
0 0 0 0 2 2 0 2 2 0 0 0 0 0 0 0 
0 0 0 0 2 2 4 2 2 2 0 2 2 0 2 2 
0 0 0 0 2 2 5 2 2 2 2 2 2 2 2 2 
0 0 0 0 2 2 5 2 2 0 0 0 0 0 0 2 
0 0 0 0 2 2 5 2 2 11 0 0 0 0 0 2 
0 0 0 0 2 2 5 2 2 2 2 2 2 0 0 2 
0 0 0 0 2 0 0 0 2 0 0 0 0 0 2 2 
0 1 0 0 0 0 0 0 0 0 0 0 0 2 2 2 
2 2 2 2 2 7 13 7 2 2 2 2 2 2 2 2 
