16 12
0 0 0 0 0 0 0 3 3 0 0 0 0 0 0 0 
0 0 4 4 0 0 0 3 3 0 0 0 4 4 0 0 
4 0 0 3 4 0 4 3 3 4 0 4 3 0 0 4 
0 0 4 3 0 0 0 3 3 0 0 0 3 4 0 0 
4 0 0 3 0 0 0 3 3 0 0 0 3 0 0 4 
0 0 4 3 0 0 0 3 3 11 0 0 3 4 0 0 
4 0 0 3 0 4 4 3 3 4 4 0 3 0 0 4 
0 0 4 3 0 0 0 0 0 0 0 0 3 4 0 0 
4 0 0 0 10 0 10 0 0 10 0 10 0 0 0 4 
0 0 4 3 10 10 0 10 10 0 10 10 3 4 0 0 
1 4 3 3 0 0 0 0 0 0 0 0 3 3 4 0 
4 3 3 3 7 7 7 7 7 7 7 7 3 3 3 4 
