16 12
1 0 0 2 0 0 0 0 0 0 0 0 2 0 0 0 
4 4 4 2 2 0 0 0 0 4 4 4 2 0 0 0 
3 3 3 2 0 2 0 0 2 3 3 3 2 0 0 0 
6 6 6 2 0 0 0 2 2 6 6 6 2 0 0 0 
6 6 6 2 0 0 2 0 2 6 6 6 2 0 0 0 
3 3 3 2 2 0 0 0 2 3 3 3 2 0 0 0 
6 6 6 2 0 2 0 0 2 6 6 6 2 0 0 0 
3 3 3 2 0 0 0 2 2 3 3 3 2 0 0 11 
0 0 0 2 0 0 2 0 2 0 0 0 2 0 0 2 
0 0 0 0 0 2 0 0 2 0 0 0 0 0 0 2 
0 0 0 0 2 0 0 0 2 0 0 0 0 2 0 2 
2 2 2 2 2 2 2 2 2 2 2 2 2 2 2 2 
