20 15
0 0 0 0 0 0 0 0 0 0 0 0 0 0 0 0 0 0 0 0 
0 0 0 0 0 0 0 5 0 0 0 0 0 0 0 0 0 0 0 0 
0 0 5 5 0 0 5 5 0 0 0 0 0 0 0 0 0 0 0 0 
0 0 0 5 5 5 5 5 0 0 0 0 0 0 0 0 0 0 0 0 
0 0 0 0 5 5 5 5 0 0 0 0 0 0 0 0 0 0 0 0 
0 0 0 0 0 0 0 5 0 0 0 0 2 0 2 0 2 0 2 0 
0 0 0 0 0 0 0 5 0 0 0 0 2 2 2 2 2 2 2 0 
0 0 0 0 0 0 0 5 0 0 0 2 2 2 2 2 2 2 2 2 
0 0 0 0 0 0 0 5 0 0 0 2 2 2 2 2 2 2 2 2 
0 0 0 0 0 0 0 5 0 0 0 2 2 2 3 3 3 2 2 2 
0 0 0 0 0 0 0 5 0 0 0 2 2 2 3 3 3 2 2 2 
0 0 1 0 0 0 0 5 0 11 0 2 2 2 3 3 3 2 2 2 
4 4 4 4 4 4 7 4 4 4 4 4 4 4 4 4 4 4 4 4 
3 3 3 3 3 3 6 3 3 3 3 3 3 3 3 3 3 3 3 3 
2 2 2 2 2 2 2 2 2 2 2 2 2 2 2 2 2 2 2 2 
