16 15
3 3 3 3 3 3 3 3 3 3 3 3 3 3 3 3 
3 0 0 0 0 0 0 0 0 0 0 0 0 3 3 3 
3 0 0 0 1 0 0 0 0 0 0 0 0 3 3 3 
3 0 0 0 4 4 0 4 4 0 0 0 0 3 3 3 
3 0 0 4 0 0 0 0 0 0 4 4 4 3 3 3 
2 2 0 0 0 0 0 5 5 4 3 3 3 3 3 3 
2 2 2 2 2 0 0 5 5 5 3 3 3 3 3 3 
2 2 2 2 2 0 0 2 2 5 3 3 3 3 3 3 
2 2 2 2 2 0 0 2 2 5 3 3 3 3 3 3 
2 2 2 2 2 0 0 2 2 5 3 3 3 3 3 3 
2 0 0 0 0 0 0 2 2 5 3 3 3 3 3 3 
2 7 7 2 0 0 0 2 2 5 3 3 3 3 3 3 
2 6 6 2 2 2 2 2 2 5 3 3 3 3 3 3 
2 6 6 2 2 2 2 2 0 0 0 11 0 0 0 0 
2 2 2 2 2 2 2 2 2 2 2 2 2 2 2 2 
