20 15
3 3 3 3 3 3 3 3 3 3 3 3 3 3 3 3 3 3 3 3 
3 0 0 0 0 0 0 0 0 0 0 0 0 0 0 0 0 5 5 3 
3 0 0 0 0 0 0 0 0 0 0 0 0 0 0 0 0 5 5 3 
3 0 0 0 0 0 0 0 0 0 0 0 0 0 0 0 5 5 5 3 
3 0 0 0 0 0 0 0 0 0 0 0 0 0 0 0 5 5 5 3 
3 0 0 0 0 0 0 0 0 0 0 0 0 0 0 0 5 5 5 3 
3 0 0 0 0 0 4 0 0 0 0 0 0 0 0 5 5 5 5 3 
3 0 1 0 0 0 0 5 4 4 4 4 5 4 4 4 4 4 4 3 
3 4 4 4 4 0 0 4 3 3 3 3 5 3 3 3 3 3 3 3 
3 3 3 3 3 0 0 0 0 0 0 0 5 0 0 0 0 0 3 3 
2 2 2 2 2 2 2 7 7 7 7 4 4 4 4 4 0 0 3 3 
2 0 0 0 0 2 2 6 6 6 6 3 5 0 0 0 0 0 3 3 
2 0 0 0 0 2 2 2 2 2 2 2 0 4 4 4 4 4 3 3 
0 0 0 11 0 0 0 0 0 0 0 0 0 3 3 3 3 3 3 3 
2 2 2 2 2 2 2 2 2 2 2 2 2 2 2 2 2 2 2 2 
