16 15
0 0 0 0 0 0 0 0 0 0 0 0 0 0 0 0 
0 0 0 0 0 0 0 0 0 0 0 0 0 0 0 0 
0 0 0 0 0 0 0 0 0 0 0 0 0 0 0 0 
0 0 0 0 0 0 0 0 0 0 0 0 0 0 0 0 
0 0 0 0 4 4 0 0 0 0 0 0 0 0 0 0 
0 0 0 0 0 5 0 4 4 0 4 4 4 0 0 4 
0 0 0 0 0 5 2 3 3 0 0 0 0 0 4 3 
0 0 1 0 0 5 2 3 3 4 0 0 0 4 3 3 
2 2 2 2 2 2 0 0 0 0 0 0 4 3 3 3 
2 0 0 0 0 0 0 0 0 0 0 4 3 3 3 3 
2 0 2 5 5 5 2 2 2 2 2 2 2 2 2 2 
2 0 2 7 7 7 2 2 2 2 2 2 2 2 2 2 
2 0 2 6 6 6 2 2 2 2 2 2 2 2 2 2 
0 11 2 6 6 6 2 2 2 2 2 2 2 2 2 2 
2 2 2 2 2 2 2 2 2 2 2 2 2 2 2 2 
