16 12
9 0 0 0 0 0 0 0 0 0 0 0 0 0 0 0 
4 4 4 4 4 4 4 0 0 0 0 0 0 0 0 0 
0 0 0 0 0 0 0 4 0 0 0 0 0 0 0 0 
0 0 0 0 0 0 0 0 4 0 0 0 0 0 0 0 
0 0 0 0 0 0 0 0 0 0 4 4 4 4 4 4 
0 0 0 0 0 0 0 0 0 4 0 0 0 0 0 0 
0 0 0 0 0 0 0 0 4 0 0 0 0 0 0 0 
0 0 0 4 4 4 4 4 0 0 0 0 0 0 10 0 
1 0 0 0 0 0 0 0 0 0 0 0 0 0 10 11 
4 4 4 10 10 10 10 10 10 10 10 10 10 13 4 4 
2 3 3 7 7 7 7 7 7 7 7 7 7 4 3 2 
2 3 6 6 6 6 6 6 6 6 6 6 6 6 3 2 
