16 15
0 0 0 0 0 0 0 0 0 0 0 0 0 0 0 0 
0 0 0 0 0 0 0 0 0 0 0 0 0 0 0 0 
0 0 0 0 0 0 0 0 0 0 0 0 0 0 0 0 
0 0 0 0 0 0 0 0 0 0 0 0 0 0 0 0 
0 0 0 0 0 0 0 4 2 2 0 4 4 0 0 4 
0 0 0 0 0 0 2 3 0 2 0 0 0 0 4 3 
0 0 1 0 0 2 2 0 10 2 0 0 0 4 3 3 
2 2 2 2 2 2 2 2 4 0 0 0 4 3 3 3 
3 3 3 0 0 0 0 0 3 0 2 0 0 0 0 2 
3 3 3 4 7 7 7 7 3 4 2 2 0 0 0 2 
3 3 3 3 6 6 6 6 3 3 2 2 2 0 0 2 
3 3 3 3 2 2 2 2 2 0 0 0 0 0 2 2 
0 11 0 3 0 0 0 0 0 0 0 0 0 2 2 2 
2 2 2 2 2 2 2 2 2 2 2 2 2 2 2 2 
2 2 2 2 2 2 2 2 2 2 2 2 2 2 2 2 
