16 12
0 0 0 0 0 0 0 0 0 0 0 0 0 0 0 0 
0 0 0 0 0 0 0 0 0 0 0 0 0 0 0 0 
0 0 0 0 0 0 0 0 0 0 0 0 0 0 0 0 
0 0 0 0 0 0 0 0 0 0 0 0 0 0 0 0 
0 0 0 0 0 0 0 0 0 0 0 0 0 0 0 0 
0 0 0 0 0 0 0 0 0 0 0 0 0 0 0 0 
0 0 0 0 0 0 0 0 0 0 0 0 0 0 0 0 
5 5 5 5 4 7 7 7 7 7 7 4 0 0 0 0 
0 0 0 0 3 6 6 6 6 6 6 3 0 0 0 0 
1 0 0 0 3 6 6 6 3 3 3 3 0 0 0 11 
4 4 4 4 3 2 6 6 0 0 0 0 0 4 4 4 
2 2 2 2 2 2 2 2 2 2 2 2 2 3 3 3 
